5
 ######
##B..A#
#@aa..#
#@@a.#
#.@a.#
######
