-1
############
#....AB....#
#@aaa....b.#
#@@a.....@.#
#..........#
#.@...@b...#
############
