-1
###############
#....AB...@...#
#........@....#
#@aaa.......b.#
#......C......#
#@@a........@.#
#...D.........#
#....c....d...#
#..@..@...b...#
###############
