5
######
#....#
#....#
#..A.#
#....#
######
