5
######
#Aa.@#
#a...#
#..A.#
#@...#
######
