-3
######
#Aa.@#
#a...#
#....#
#@...#
######
