5
 ######
##...A#
#.aa..#
#..a.#
#..a.#
######
