5
 ######
##b..A#
#@aa..#
#@@a.#
#@@a.#
######
